Description

	小毅有一天睡覺起床，發現他的房間竟然變成了一間迷宮

	他每天身處迷宮中找尋出路，找的頭髮都快白了

	請你寫一隻程式幫助小毅找到迷宮的出路


Input
	首先輸入迷宮長寬

	接著輸入以0與1所構成的迷宮

	0代表該格可以通行

	1代表牆壁

	迷宮入口為迷宮左上角那格，一定為0

	迷宮出口為迷宮右下角那格，也一定為0


Output
	每次可選擇往上、下、左、右移動一格，請由迷宮路口開始輸出行走至迷宮出口的路徑+

	若沒有路徑能走出迷宮，則輸出Can't reach the exit!

Sample Input 1 

4 6
0 0 1 1 1 1
1 0 0 0 1 1
1 0 1 1 1 1
1 0 0 0 0 0

Sample Output 1

(0,0) (0,1) (1,1) (2,1) (3,1) (3,2) (3,3) (3,4) (3,5)

Sample Input 2 

16 30
0 1 1 1 1 1 1 1 1 1 1 1 1 1 1 1 1 1 1 1 1 1 1 1 1 1 1 1 1 1
1 1 1 1 1 1 0 0 1 1 1 1 1 1 1 1 1 1 1 1 1 1 1 1 1 1 1 1 1 1
1 1 1 1 1 1 0 0 1 1 1 1 1 1 1 1 0 0 0 0 0 0 1 0 0 0 0 0 0 1
1 1 1 0 1 1 0 0 1 1 0 1 1 1 1 1 0 0 0 0 0 0 1 0 0 1 1 0 0 1
1 1 0 0 1 1 0 0 1 1 0 0 1 1 1 1 0 0 1 1 0 0 1 0 0 0 0 0 0 1
1 0 0 1 1 1 0 0 1 1 1 0 0 1 1 1 0 0 1 1 0 0 1 0 0 0 0 0 0 1
0 0 1 1 1 1 0 0 1 1 1 1 0 0 1 1 0 0 0 0 0 0 1 0 0 1 1 0 0 1
0 1 1 1 1 1 0 0 1 1 1 1 1 0 1 1 0 0 0 0 0 0 1 0 0 0 0 0 0 1
1 1 1 1 1 1 0 0 1 1 1 1 1 1 1 1 0 0 1 1 0 0 1 0 0 0 0 0 0 1
1 1 1 1 0 1 0 0 1 1 1 1 1 1 1 1 0 0 0 0 0 0 1 0 0 1 1 0 0 1
1 1 1 1 0 0 0 0 1 1 1 1 1 1 1 1 0 0 0 0 0 0 1 0 0 1 1 0 0 1
1 1 1 1 1 0 0 0 1 1 1 1 1 1 1 1 1 1 1 1 1 1 1 0 0 1 1 0 0 1
1 1 1 1 1 1 1 1 1 1 1 1 1 1 1 1 1 1 1 1 1 1 1 0 0 1 1 0 0 1
1 1 1 1 1 1 1 1 1 1 1 1 1 1 1 1 1 1 1 1 1 1 0 0 0 1 0 0 0 1
1 1 1 1 1 1 1 1 1 1 1 1 1 1 1 1 1 1 1 1 1 1 1 0 0 1 1 0 0 1
1 1 1 1 1 1 1 1 1 1 1 1 1 1 1 1 1 1 1 1 1 1 1 1 1 1 1 1 1 0

Sample Output 2

Can't reach the exit!